0000000000000000000
0001111111100000000
0000001000000000000
0000001000000000000
000000000b000000000
0000001111100000000
0000000a00000000100
0000000000000000100
0000000000000000100
0011111100000000100
0000000000000000100
0000000000000000000
