11111111111111111111111
1a000000000000000000001
10101010101010101010101
10000000000000000000001
10101010101010101010101
10000000000000000000001
10101010101010101010101
10000000000000000000001
10101010101010101010101
100000000000000000000b1
11111111111111111111111