a00000000100000000
010101010101010100
000000000000000000
010101010101010100
000000000000000000
010101010101010100
000000000000000000
010101010101010100
000000000000000000
010101010101010100
000000000100000000
01010101010101010b
