0000a0100000001000000000000000
101111100010001000000000000000
000000000010000011111000000000
111000111111111110000000010000
001000100000000000000000100000
000000100000011111100001000000
000111100000000100000010000000
000000000000000000000000000000
000001100000111111100000000000
000000110000100000000000000000
000000000000100001111111110000
000001111000100001000000000000
000100000000000001000001111100
000100000000000001000000000100
000100000011111000000000000111
00010000000000000000000000000b