a00000000000000000000
010101010101010101010
000000000000000000000
010101010101010101010
000000000000000000000
010101010101010101010
000000000000000000000
010101010101010101010
00000000000000000000b
