a11110000011100000
000000000100000000
001101100101101100
00000000010000000b
011101101101101101
000000000000000000
001101100001101100
000000000100000000
011101101101101101
000000000100000000
001101100101101100
000000000100000000
011100000100000111
000000000100000000
011110000011110000
