000000000000000000
000000000000000000
000000000000000000
000001111100000000
00000000b110000000
000000000100a00000
000000000100000000
000000111100000000
000000000000000000
000000000000000000
000000000000000000
000000000000000000
000000000000000000
000000000000000000
000000000000000000
