000000000000000000
000000000000000000
000000000000000000
000001111100000000
00000000b110000000
000000000100000000
000000000100000000
00000011110a000000
000000000000000000
000000000000000000
000000000000000000
000000000000000000
000000000000000000
000000000000000000
000000000000000000
