a00000000110000000
011111010101010100
000100010001000100
010101010101010100
000100000000010000
010101110111010100
000001000100010000
010101010101010100
000100010001000100
010101010101010100
000000111100000000
01010101010101010b